[MAP:72:28]
WWWWWWWWWWWWWWWWWWWWWWWWWWWWWWWWW________WWWWWWWWWWWWWWWWWWWWWWWWWWWWWWW
WWW____________________________WW________WW__________________________WWW
WW____________________________________________________________________WW
W______________________________________________________________________W
W___________________W____________________________________________F_____W
W___________________WWW_____________F__________________________________W
W__________F__________WW________________________WW_____________________W
W____________________F__________________________WW_____________________W
W______________________________________________________________________W
W______________________________________________________________________W
W______________________________________________________________________W
________________________________________________________________________
__________WWWWWWWWWWW_______________S__________WWWWWWWWWW_______________
______________________________________________________________________F_
________________________________________________________________________
W______________________________________________________________________W
W______________________F____________W___________F______________________W
W___________________________________W__________________________________W
W___________________________________W__________________________________W
W___________WW______________________W______________WWWWWWWWWWW_________W
W___________WW______________________W______________W___________________W
W__________________________________WWW_____________W___________________W
W________________________________WWWWWWW___________W___________________W
W__________F_______________________________________W__________F________W
W______________________________________________________________________W
W_____________________________________________________________________WW
W____________________________________________________________________WWW
WWWWWWWWWWWWWWWWWWWWWWWWWWWWWWWW_________WWWWWWWWWWWWWWWWWWWWWWWWWWWWWWW
