[MAP:71:27]
_______________________________________________________________________
_______________________________________________________________________
_______________________________________________________F_______________
_________F_____________________________________________________________
________________WWWWWWWWWWWWWWWWWWWW___________________________________
______________________________________________________________W________
_____W________________________________________________________W________
_____W______________________________W__________________________________
_____W_____________F_F______________W__________________________________
_____W______________________________W_WWWWWWWWWWWWWWWW_________________
____________________________________W__________________________________
____________________________________W_________________________W________
____________________________________W_________________________W________
______________________________________________________________W________
______WWW__________WSW________________________________________W________
__F_____W__________WWW_________________________________________________
________W______________________________________________________________
____________________________WWWWWWWWWWWW_______________________________
_______________________________________________________________________
________________________________________________________F______________
______W_________F______________________________________________________
______WW_______________________________________________________________
_______WW________________WWW__________F________________________________
________WW_______________WWW____________________WWWWWWWWWWWWWW_________
_________WW______________WWW___________________________________________
_______________________________________________________________________
_______________________________________________________________________